11111111
1E000001
10010011
1C1C0001
10P00001
11000011
1111C111
