11111111
1E000001
10010011
1C1C0H01
10P00001
11000011
11111111
