11111111
1E010001
11010011
1C1C0001
10P00001
11000011
11111111
