11111111
1E00P001
10010011
11111111
