111111111111111
110C10000000001
100100110001101
1C1C0000111C001
10P00E0CC0000C1
11000011C00C011
1C0C0C000110001
111111111111111
