1111111111
11PC000001
1001001101
101C000011
10101E1001
10010001C1
100C010001
1C011C0001
100101C101
1111111111
